1111111111111111111111111111111111
1E0000000000000C0X000C000000000001
1010010100100000101001000000010101
1010010010101010001001000000010101
100000000C00C000000001000000000PC1
1111111111111111111111111111111111