1111111111111111111111
1010001011101110101111
1010101111111111111011
1000000P000000000X1111
1011101011111010111011
1111111011101010001011
10X0111011111010111011
1010101011111110101011
1110111010001010111011
1000C00C1010100000X0E1
1111111111111111111111