1111111111111111
1C000011C0C11111
11111011011110E1
1111001100111011
1111000000000011
10000111110110C1
1P00C111110C1111
1111110111111111